.....................................***...*....*.....*.....*...*..*****.................................
....................................*......*.*..*....*.*....*..*...*.....................................
.....................................**....*.*..*...*...*...*..*...****..................................
.......................................*...*..*.*..*******..***....*.....................................
........................................*..*..*.*..*.....*..*..*...*.....................................
....................................****...*....*..*.....*..*...*..*****.................................
...........|||||||||||||||||||||||||||||||||||||||||||||||||||||||||||||||||||||||||||||||||||||||.......
...........|.....................................................................................|.......
...........|.....................................................................................|.......
...........|.....................................................................................|.......
...........|............................................|........................................|.......
...........|............................................|........................................|.......
...........|............................................|........................................|.......
...........|............................................|........................................|.......
...........|..............................|||||||||||||||||||||||||||||..........................|.......
...........|............................................|........................................|.......
...........|............................................|........................................|.......
...........|............................................|........................................|.......
...........|............................................|........................................|.......
...........|.....................................................................................|.......
...........|.....................................................................................|.......
...........|.....................................................................................|.......
...........|||||||||||||||||||||||||||||||||||||||||||||||||||||||||||||||||||||||||||||||||||||||.......
.........................................................................................................
.........................................................................................................
.........................................................................................................
.........................................................................................................
.........................................................................................................
.........................................................................................................
.........................................................................................................
.........................................................................................................
.........................................................................................................
.........................................................................................................
.........................................................................................................
.........................................................................................................
.........................................................................................................
.........................................................................................................
.........................................................................................................
.........................................................................................................
.........................................................................................................
.........................................................................................................
.........................................................................................................
.........................................................................................................
.........................................................................................................
.........................................................................................................
.........................................................................................................
.........................................................................................................
.........................................................................................................
.........................................................................................................
.........................................................................................................
.........................................................................................................
.........................................................................................................
.........................................................................................................
.........................................................................................................
.........................................................................................................
.........................................................................................................
