.........................................................................................................
.........................................................................................................
.........................................................................................................
...........|-------------------------------------------------------------------------------------|.......
...........|.....................................................................................|.......
...........|.............................||...........................||.........................|.......
...........|...........................||...............................||.......................|.......
...........|.........................||.................|................||......................|.......
...........|................||..........................|...........................||...........|.......
...........|..............||............................|.............................||.........|.......
...........|............||..............................|...............................||.......|.......
...........|..........||..................|||||||||||||||||||||||||||||...............||.........|.......
...........|.............||..............................|...........................||..........|.......
...........|...............||............................|.........................||............|.......
...........|........................||...................|..............||.......................|.......
...........|..........................||.................|............||.........................|.......
...........|............................||..........................||...........................|.......
...........|.....................................................................................|.......
...........|.....................................................................................|.......
...........|_____________________________________________________________________________________|.......
.........................................................................................................
.........................................................................................................
.........................................................................................................