.....................................***...*....*.....*.....*...*..*****.................................
....................................*......*.*..*....*.*....*..*...*.....................................
.....................................**....*.*..*...*...*...*..*...****..................................
.......................................*...*..*.*..*******..***....*.....................................
........................................*..*..*.*..*.....*..*..*...*.....................................
....................................****...*....*..*.....*..*...*..*****.................................
...........|-------------------------------------------------------------------------------------|.......
...........|.....................................................................................|.......
...........|.............................||...........................||.........................|.......
...........|...........................||...............................||.......................|.......
...........|....................|||..||.................|................||..|||||...............|.......
...........|................||..........................|...........................||...........|.......
...........|..............||............................|.............................||.........|.......
...........|............||..............................|...............................||.......|.......
...........|..........||..................|||||||||||||||||||||||||||||...............||.........|.......
...........|.............||.............................|............................||..........|.......
...........|...............||...........................|..........................||............|.......
...........|...................|||||||..................|...............||||.....................|.......
...........|..........................||................|.............||.........................|.......
...........|............................||..||||||||||.....||||||||..||...........................|.......
...........|.....................................................................................|.......
...........|.....................................................................................|.......
...........|_____________________________________________________________________________________|.......
.........................................................................................................
.........................................................................................................
.........................................................................................................
.........................................................................................................
.........................................................................................................
.........................................................................................................
.........................................................................................................
.........................................................................................................
.........................................................................................................
.........................................................................................................
.........................................................................................................
.........................................................................................................
.........................................................................................................
.........................................................................................................
.........................................................................................................
.........................................................................................................
.........................................................................................................
.........................................................................................................
.........................................................................................................
.........................................................................................................
.........................................................................................................
.........................................................................................................
.........................................................................................................
.........................................................................................................
.........................................................................................................
.........................................................................................................
.........................................................................................................
.........................................................................................................
.........................................................................................................
.........................................................................................................
.........................................................................................................
.........................................................................................................
.........................................................................................................
